12 12
111111111111
110000000001
110000000001
120000090021
110000011111
120000010001
110000010001
120000010001
110011111121
110020000001
110000000001
111111111111
