12 12
111111111111
110200000001
110020000001
120000090031
110030011111
120200010001
110030010001
120000010001
110011111121
110020030001
110000000001
111111111111
