12 12
111111111111
11 p       1
11  p      1
1p     @  f1
11  f  11111
1p p   1   1
11  f  1   1
1p     1   1
11  111111p1
11  p  f   1
11         1
111111111111
