12 12
111111111111
110000000001
110000000001
120000000001
110000000001
120000011111
110000010001
120000010901
110011111121
110020000001
110000000001
111111111111
