12 12
111111111111
110000000001
110000000001
100000000001
110000000001
100000011111
110000010001
100000010001
110011111101
110000000001
110000000001
111111111111
