12 12
111311113111
11* p     *1
11  p      2
2*     @  f1
11  f  11111
2* p   1   1
11  f  3   2
2p     1   1
11  111111p1
11  p  f   1
11*        1
111111111111
