12 12
111311411311
11* p     *1
11  p     c3
2*     @  f1
11  f  11-11
2* p   1  *1
11  f  3   2
2p     1* c1
11  111111p1
11  pc f  c1
11*        1
111111314111
